00000000000000000000000
01011111110111110111111
01010101000100010100000
01110101111101011101110
01000101010001000001010
01111101010111111111010
01000001010101010000010
010aaa01011101010bbb010
010aaa01000001000bbb010
010aaa01110101110bbb011
01000001010101010bbb010
01011111111111110bbb011
01010000000001010000000
0101111ccccc01011101111
0100010ccccc00000101000
0111110ccccc01110111010
00000000000000000000000