00000000
01011111
01010100
01010111
01010000