00000000000000000000000100000000000000000000000
01011111110111110111111111111101111111111111110
01010101000100010100000000010001000000000001010
01110101111101011101110222011101010222222201010
01000101010001000001010222000101010222222201010
01111101010111111111010222010111010222222201110
01000001010101010000010222010000010000000001010
01022201011101010222010222011111111101111101010
01022201000001000222010000010001010101000101010
01022201110101110222011111111111110101011111110
01000001010101010222010000000000000101000000010
01011111111111110222011111022201110101022222010
01010000000001010000000001022201010101022222010
01011112222201011101111101022201011101022222010
01000102222200000101000101000001000101022222010
01111102222201110111010111011101022201022222010
01010102222201010100010000010101022201022222010
01010102222201011101111101110101022201022222010
01010102222201010001010001010101022201000100010
01111102222201011111011111010101022201011101110
00000100000001000000000000010101022201010100010
01111111111101110111022201010101022201010111010
01000100000101010101022201010001000001010001010
01011101111101110101022201011111110111011101010
01010001000101000101022201010000000101000101000
01010111011101011101022201111102220101111101110
01010100010101010000000000010102220100010100010
01010101110111011111111111010102220111110111110
01010101000000000001000101010102220000000100010
01011101110222011101111111110102220111110101110
01000000010222010101000000000102220001010101010
01111111010222010111010222220102220111011101010
00010101010000010000010222220100000101010101000
01110101011101111101110222220111111101111101110
01000101000101000101010000010001000101010100010
01111111110101110101011101111101111111110111110
01010100010101010101000101010001000000010100010
01110111110111111101111101010111022222010101010
01000100010000000001000001010101022222010101010
01111101110222220111111111010111022222010101010
00000101000222220100000001010001000000000101010
01111101110222220102222201011111110111111101110
01000000010222220102222201000001000100010000010
01022201111222220102222201011111110111110222010
01022201010000000100000100010100010000010222010
01022201011101111111110111110111010111110222010
01000001000001000000010100000100010101010000010
01111111111111111111110101111111111101110111110
00000000000000000000000100000000000000000000000