000000000
011111110
010101010
010101110
011101010
010111110
000000000