000000000
011100100
010101110
011100100
000000000
000100000
000100000
011111000
000100000
000100000
000000000
000000000
011111010
010101010
011111010
010101010
011111010
