#47,49
00000000000000000000000100000000000000000000000
01011111111111111111011111011111111111111111110
01010100000000000001010001000100010001000000010
01010111111111111101011101110111110101111111010
01010000010100000101010101010000010100000101010
01110111110111111101010111011111110111111101010
00000101000101000001000101000101010000000101010
01111101011101011101110101011101011111111101110
01010001010100010100010001010101010000000001010
01011111010111110111011111011111011101111111110
01010001010000000001000000010000000101010101000
01011111010111111101111101111111111101011101110
01000101010100000101010001010001010101010001010
01110111011101110101010111010111011111010111010
01010100000001010101010100010101000101010101010
01011111111111111101010111010101110101010111110
01010100000000000101000100010100010001010100010
01010111111111011101111101110111010111011101110
01010000000001010000000101010001010100000001010
01011111111101010111111111011111011101111111010
01000000000101010100010000000100000001010000010
01011111110101111111110111111101111111011111010
01000000010101000000010101000001000000000001010
01011111110101011101111101111111011101111101010
01010101010101010101010101000100010101000101010
01010111010101010111010101111111010111010111010
01010100000101010000010101000001010100010000010
01110101110111010111110101011111111111111111010
01010101010001010000000101010001000100000100010
01110111010111011101111101010111010101110111110
01000100010100010101000001010100010100010000000
01011101011101111111110101011111011101110111110
01010001000001010001010101010001010001000101010
01010101110111010111010101111111011111111101010
01010101010101010101010100010100010001000001010
01110101010111010101010111111111011101110111010
01010101010001010101010100000101000100000100010
01110111111111011101010101110101110111011111010
00010100000101000001010001010000010101010001010
01110101110111111111011101011111010111111111110
01010001010001010000000101010001010001000100000
01011111111111011111111111011101011111011111110
01000101000001000000010000010101010001000100010
01011101110101111111110101111101011101110111010
01010101010100000000010101000101000000010001010
01110111010111111111010111011101110111110111010
01000100010000000101010001010000010100000100010
01111101111111111101111101011111111111111111110
00000000000000000000000100000000000000000000000